SPPPP0000000000
000P00000000000
000P00000000000
000P00000000000
000PPPPPPP00000
000000000P00000
000000000PPPP00
000000000000PP0
0000000000000PE
