00S000000000000
00P000000000000
00P00P000000000
00PT0PPP0000000
00PT0P0P0000000
00PPPPPPPP00000
00TT000P0000000
0000000P0000000
0000000E0000000
