00S000000000000
00P000000000000
00P000000000000
00PT00000000000
00PT00000000000
00PPPPPP0000000
00TT000P0000000
0000000P0000000
0000000E0000000
