0S00T0000000000
0PPPPPPT0000000
0T0TPTP00000000
0000PPPT000T0T0
000000PT000PPPE
00000TP0000PTT0
000000PT0PTP000
00000TPPPPPPP00
00000000T00T000
